........................................
........................................
........................................
...##################################...
...#.......#......#.....#..#......#.#...
...#..####.#.###..##..#.#..#####..#.#...
...#.....#.#.#........#.#......#..#.#...
...#######.#.######..##.###..###..#.#...
...#...........#......#......#......#...
...#..#..###.###......###....#####..#...
...#..#..#.......###................#...
...#..#..#######...#......#..###....#...
...#..#........#...#.###..#....#....#...
...#..#####..###...#...#..###########...
...#......#..#.....#...#..#..#......#...
...#####..#..#.....########..#..#...#...
...#...#..#..........#.......#..#...#...
...#...#.....#########....#..####...#...
...#.................#....#...#.....#...
...#....#########....######...#.........
...#....#............#..................
...#....#............#........####......
...#....#............#....#...#..#..#...
...#....##############....#...#..#..#...
...#.........#............#...#.....#...
...#....#....#..####......#...#######...
...#....######.....#...####.........#...
...#......#..#######...#............#...
...####................#######......#...
...#...#......####...#........#.....#...
...#...###.......#...#....#####.....#...
...#...#.......#####................#...
...#...######..#.........###...######...
...#........#..#....#....#.#.#...#..#...
...#........####....######.#.#...#..#...
...#................#........#......#...
...##################################...
........................................
........................................
........................................
